11111111111111
1PCE1001001001
11111111111111
10000000000001
10000000000001