111111111111111
111111111111111
1P000000C0000E1
111011101110111
1C00100010001C1
101110111011101
1C000C001C000C1
111011101110111
1C00100010001C1
101110111011101
1C000C001C000C1
111011101110111
1C00100010001C1
100000C000000C1
1C00011111000C1
111111111111111

